"filename", "language", "Python", "JSON", "comment", "blank", "total"
"/home/fpuoti/GIT/OLA_project/src/Ecommerce.py", "Python", 55, 0, 17, 22, 94
"/home/fpuoti/GIT/OLA_project/src/Ecommerce3.py", "Python", 84, 0, 5, 31, 120
"/home/fpuoti/GIT/OLA_project/src/Ecommerce4.py", "Python", 62, 0, 0, 24, 86
"/home/fpuoti/GIT/OLA_project/src/Ecommerce5.py", "Python", 83, 0, 4, 25, 112
"/home/fpuoti/GIT/OLA_project/src/Ecommerce6.py", "Python", 157, 0, 5, 69, 231
"/home/fpuoti/GIT/OLA_project/src/Environment.py", "Python", 144, 0, 22, 73, 239
"/home/fpuoti/GIT/OLA_project/src/Network.py", "Python", 76, 0, 10, 23, 109
"/home/fpuoti/GIT/OLA_project/src/Non_Stationary_Environment.py", "Python", 76, 0, 6, 44, 126
"/home/fpuoti/GIT/OLA_project/src/Simulation.py", "Python", 398, 0, 18, 163, 579
"/home/fpuoti/GIT/OLA_project/src/Social_influence.py", "Python", 82, 0, 9, 26, 117
"/home/fpuoti/GIT/OLA_project/src/Utils.py", "Python", 63, 0, 12, 39, 114
"/home/fpuoti/GIT/OLA_project/src/constants.py", "Python", 15, 0, 4, 8, 27
"/home/fpuoti/GIT/OLA_project/src/step7/Algorithms.py", "Python", 33, 0, 0, 10, 43
"/home/fpuoti/GIT/OLA_project/src/step7/ContextNode.py", "Python", 78, 0, 6, 32, 116
"/home/fpuoti/GIT/OLA_project/src/step7/Ecommerce7.py", "Python", 46, 0, 0, 22, 68
"/home/fpuoti/GIT/OLA_project/src/step7/__init__.py", "Python", 1, 0, 0, 0, 1
"/home/fpuoti/GIT/OLA_project/src/trial_notebook.ipynb", "JSON", 0, 196, 0, 1, 197
"Total", "-", 1453, 196, 118, 612, 2379